%%%%%%%%%%%%%%%%%%%%%%%%%%%%%%%%
%P%   %   %         %        % %
% % % % % %         %        %.%
%   %   % %         %        % %
% %%%%%%% %         %        % %
% %...%                      %.%
% %   % %%%%%%%%%%%%%%%%     % %
% % % % %              %     %.%
% % % % %              %     % %
% % % % %              %     % %
% % % % %              %  .  % %
% % % % %              % %%% % %
% % % % %              % % % % %
% %o% % %%%%%%%%%%%%%%%% %%%o% %
%                              %
%%%%%%%%%%%%%%%%%%%%%%%%%%%%%%%%