%%%%%%%%%%%%%%%%%%%%%%%%
%P%   %   %          % %
% % % % % %          %.%
%   %   % %          % %
% %%%%%%% %          % %
% %...%              %.%
% %   % %%%%%%%%  .  % %
% % % % %      % %%% %.%
% % % % %      % % % % %
% %o% % %%%%%%%% %%%o% %
%                      %
%%%%%%%%%%%%%%%%%%%%%%%%